SO textures/barrel.xpm

NO textures/other.xpm
EA textures/no.xpm
WE textures/north.xpm







F 173,255,47





C 173,216,230
1111111111111111111111111    
1000100000010000000000001
10000000000N0000000000001
1000100000000000000000001
1111111111111111111111111
